14,15,09,09,09,09,00,00,09,09,09,09,09,09,20,20,09,09,09,09,19,19,19,03,03
14,15,09,09,01,06,00,09,09,08,08,08,09,20,20,20,09,09,09,09,19,20,19,03,19
14,15,09,01,00,00,00,09,09,08,09,08,09,09,20,20,09,09,10,12,19,19,03,03,19
14,15,01,00,00,00,09,19,09,00,06,09,09,09,09,19,19,19,16,18,19,19,19,03,19
14,15,01,00,09,09,19,19,09,00,00,00,09,09,09,19,19,19,19,19,19,19,09,03,19
17,18,01,00,09,10,11,11,12,09,00,06,09,09,19,19,20,19,19,19,19,19,19,03,03
09,01,00,00,09,13,14,14,15,09,00,00,06,09,09,19,19,09,19,19,19,19,09,09,03
01,00,00,04,09,13,14,14,15,09,09,00,00,09,09,09,09,09,09,09,09,09,09,09,09
01,00,00,04,09,16,17,17,18,09,09,09,00,09,09,09,09,09,09,09,09,19,19,19,08
01,00,00,04,09,09,09,09,09,19,09,09,00,09,09,09,09,09,09,09,09,19,08,00,00
01,00,00,04,09,09,09,19,19,19,19,19,09,09,10,11,12,09,09,09,19,19,00,00,04
01,00,00,04,09,09,19,19,19,19,19,09,09,09,16,17,18,09,09,19,19,00,00,04,09
03,02,02,05,09,09,19,19,19,19,19,09,09,09,09,09,09,09,09,19,00,00,00,00,09
09,09,09,09,09,09,20,20,20,20,20,20,09,09,09,09,09,09,09,01,00,00,00,04,09
09,09,09,09,20,20,20,20,20,20,20,09,09,09,00,00,00,01,00,00,00,09,04,09,09
09,09,20,20,20,20,20,20,20,20,20,09,09,00,00,00,00,01,00,09,09,09,04,09,09
09,20,20,20,20,20,20,20,20,09,09,09,09,09,09,01,00,00,00,09,09,09,09,09,09
09,20,20,20,20,20,20,20,20,20,09,20,20,09,09,03,01,00,09,09,09,09,09,09,09
09,09,19,19,19,20,20,20,20,20,20,20,19,19,20,20,01,00,09,10,12,09,09,09,09
09,20,20,20,20,20,20,20,20,20,20,19,19,20,20,09,03,00,09,16,18,09,09,09,09

1,1,1,1,1,1,1,1,1,1,1,1,1,1,1,1,1,1,1,1,1,1,1,1,1
1,0,0,0,0,0,0,0,0,0,0,0,0,0,0,0,0,0,0,0,0,0,0,0,1
1,0,0,0,0,0,0,0,0,0,0,0,0,0,0,0,0,0,0,0,0,0,0,0,1
1,0,0,0,0,0,0,0,0,0,0,0,0,0,0,0,0,0,0,0,0,0,0,0,1
1,0,0,0,0,0,0,0,0,0,0,0,0,0,0,0,0,0,0,0,0,0,0,0,1
1,0,0,0,0,0,0,0,0,0,0,0,0,0,0,0,0,0,0,0,0,0,0,0,1
1,0,0,0,0,0,0,0,0,0,0,0,0,0,0,0,0,0,0,0,0,0,0,0,1
1,0,0,0,0,0,0,0,0,0,0,0,0,0,0,0,0,0,0,0,0,0,0,0,1
1,0,0,0,0,0,0,0,0,0,0,0,0,0,0,0,0,0,0,0,0,0,0,0,1
1,0,0,0,0,0,0,0,0,0,0,0,0,0,0,0,0,0,0,0,0,0,0,0,1
1,0,0,0,0,0,0,0,0,0,0,0,0,0,0,0,0,0,0,0,0,0,0,0,1
1,0,0,0,0,0,0,0,0,0,0,0,0,0,0,0,0,0,0,0,0,0,0,0,1
1,0,0,0,0,0,0,0,0,0,0,0,0,0,0,0,0,0,0,0,0,0,0,0,1
1,0,0,0,0,0,0,0,0,0,0,0,0,0,0,0,0,0,0,0,0,0,0,0,1
1,0,0,0,0,0,0,0,0,0,0,0,0,0,0,0,0,0,0,0,0,0,0,0,1
1,0,0,0,0,0,0,0,0,0,0,0,0,0,0,0,0,0,0,0,0,0,0,0,1
1,0,0,0,0,0,0,0,0,0,0,0,0,0,0,0,0,0,0,0,0,0,0,0,1
1,0,0,0,0,0,0,0,0,0,0,0,0,0,0,0,0,0,0,0,0,0,0,0,1
1,0,0,0,0,0,0,0,0,0,0,0,0,0,0,0,0,0,0,0,0,0,0,0,1
1,1,1,1,1,1,1,1,1,1,1,1,1,1,1,1,1,1,1,1,1,1,1,1,1